#
# 0 D room1.txt 1
# 1 D room1.txt 0 key1
# 2 E room2.txt 0
#
# k key2
#
WWWW0WWWWW
W s    s W
W    s   W
W s      W
W        W
W      WWW
W  H   WkW
W      W W
W      W 1
WWWW2WWWWW